1 1 1 2 2 2 3 4 5 
6 7 8 9 10 11 3 4 5 
6 7 8 9 10 11 3 4 5 
6 7 8 9 10 11 12 13 14 
15 16 17 18 19 20 12 13 14 
15 16 17 18 19 20 12 13 14 
15 16 17 18 19 20 21 22 23 
24 25 26 27 28 29 21 22 23 
24 25 26 27 28 29 21 22 23 
24 25 26 27 28 29 30 31 32 
33 33 33 34 34 34 30 31 32 
35 35 35 36 36 36 30 31 32 
1 1 1 2 2 2 3 3 3 4 4 4 5 6 
7 8 9 10 11 12 13 14 15 16 17 18 5 6 
7 8 9 10 11 12 13 14 15 16 17 18 5 6 
7 8 9 10 11 12 13 14 15 16 17 18 19 20 
21 22 23 24 25 26 27 28 29 30 31 32 19 20 
21 22 23 24 25 26 27 28 29 30 31 32 19 20 
21 22 23 24 25 26 27 28 29 30 31 32 33 34 
35 36 37 38 39 40 41 42 43 44 45 46 33 34 
35 36 37 38 39 40 41 42 43 44 45 46 33 34 
35 36 37 38 39 40 41 42 43 44 45 46 47 48 
49 49 49 50 50 50 51 51 51 52 52 52 47 48 
53 53 53 54 54 54 55 55 55 56 56 56 47 48 
1 1 1 2 3 
4 5 6 2 3 
4 5 6 2 3 
4 5 6 7 8 
9 10 11 7 8 
9 10 11 7 8 
9 10 11 12 13 
14 15 16 12 13 
14 15 16 12 13 
14 15 16 17 18 
19 20 21 17 18 
19 20 21 17 18 
19 20 21 0 0 
1 1 1 2 2 2 3 3 3 4 5 
6 7 8 9 10 11 12 13 14 4 5 
6 7 8 9 10 11 12 13 14 4 5 
6 7 8 9 10 11 12 13 14 15 16 
17 18 19 20 21 22 23 24 25 15 16 
17 18 19 20 21 22 23 24 25 15 16 
17 18 19 20 21 22 23 24 25 0 0 
1 1 1 2 
3 4 5 2 
3 4 5 2 
3 4 5 6 
7 8 9 6 
7 8 9 6 
7 8 9 10 
11 12 13 10 
11 12 13 10 
11 12 13 14 
15 16 17 14 
15 16 17 14 
15 16 17 18 
19 19 19 18 
20 20 20 18 
1 1 1 2 2 2 3 3 3 4 
5 6 7 8 9 10 11 12 13 4 
5 6 7 8 9 10 11 12 13 4 
5 6 7 8 9 10 11 12 13 14 
15 16 17 18 19 20 21 22 23 14 
15 16 17 18 19 20 21 22 23 14 
15 16 17 18 19 20 21 22 23 0 
24 24 24 25 25 25 26 26 26 0 
1 1 1 2 2 2 3 3 3 4 5 
6 7 8 9 10 11 12 13 14 4 5 
6 7 8 9 10 11 12 13 14 4 5 
6 7 8 9 10 11 12 13 14 15 16 
17 18 19 20 21 22 23 24 25 15 16 
17 18 19 20 21 22 23 24 25 15 16 
17 18 19 20 21 22 23 24 25 26 27 
28 29 30 31 32 33 34 35 36 26 27 
28 29 30 31 32 33 34 35 36 26 27 
28 29 30 31 32 33 34 35 36 0 0 
1 1 1 2 2 2 3 3 3 4 
5 6 7 8 9 10 11 12 13 4 
5 6 7 8 9 10 11 12 13 4 
5 6 7 8 9 10 11 12 13 14 
15 16 17 18 19 20 21 22 23 14 
15 16 17 18 19 20 21 22 23 14 
15 16 17 18 19 20 21 22 23 24 
25 26 27 28 29 30 31 32 33 24 
25 26 27 28 29 30 31 32 33 24 
25 26 27 28 29 30 31 32 33 34 
35 35 35 36 36 36 37 37 37 34 
38 38 38 39 39 39 40 40 40 34 
1 1 1 2 2 2 3 3 3 4 4 4 5 
6 7 8 9 10 11 12 13 14 15 16 17 5 
6 7 8 9 10 11 12 13 14 15 16 17 5 
6 7 8 9 10 11 12 13 14 15 16 17 18 
19 20 21 22 23 24 25 26 27 28 29 30 18 
19 20 21 22 23 24 25 26 27 28 29 30 18 
19 20 21 22 23 24 25 26 27 28 29 30 31 
32 33 34 35 36 37 38 39 40 41 42 43 31 
32 33 34 35 36 37 38 39 40 41 42 43 31 
32 33 34 35 36 37 38 39 40 41 42 43 44 
45 46 47 48 49 50 51 52 53 54 55 56 44 
45 46 47 48 49 50 51 52 53 54 55 56 44 
45 46 47 48 49 50 51 52 53 54 55 56 0 
1 1 1 2 3 4 
5 6 7 2 3 4 
5 6 7 2 3 4 
5 6 7 8 9 10 
11 12 13 8 9 10 
11 12 13 8 9 10 
11 12 13 14 15 16 
17 18 19 14 15 16 
17 18 19 14 15 16 
17 18 19 20 21 22 
23 24 25 20 21 22 
23 24 25 20 21 22 
23 24 25 26 27 28 
29 30 31 26 27 28 
29 30 31 26 27 28 
29 30 31 32 33 34 
35 35 35 32 33 34 
36 36 36 32 33 34 
