1 1 1 2 2 2 3 3 3 4 4 4 5 5 5 6 7 
8 9 10 11 12 13 14 15 16 17 18 19 20 21 22 6 7 
8 9 10 11 12 13 14 15 16 17 18 19 20 21 22 6 7 
8 9 10 11 12 13 14 15 16 17 18 19 20 21 22 23 24 
25 26 27 28 29 30 31 32 33 34 35 36 37 38 39 23 24 
25 26 27 28 29 30 31 32 33 34 35 36 37 38 39 23 24 
25 26 27 28 29 30 31 32 33 34 35 36 37 38 39 40 41 
42 43 44 45 46 47 48 49 50 51 52 53 54 55 56 40 41 
42 43 44 45 46 47 48 49 50 51 52 53 54 55 56 40 41 
42 43 44 45 46 47 48 49 50 51 52 53 54 55 56 57 58 
59 60 61 62 63 64 65 66 67 68 69 70 71 72 73 57 58 
59 60 61 62 63 64 65 66 67 68 69 70 71 72 73 57 58 
59 60 61 62 63 64 65 66 67 68 69 70 71 72 73 74 75 
76 77 78 79 80 81 82 83 84 85 86 87 88 89 90 74 75 
76 77 78 79 80 81 82 83 84 85 86 87 88 89 90 74 75 
76 77 78 79 80 81 82 83 84 85 86 87 88 89 90 0 0 
1 1 1 2 2 2 3 
4 5 6 7 8 9 3 
4 5 6 7 8 9 3 
4 5 6 7 8 9 0 
1 1 1 2 2 2 3 3 3 4 4 4 5 
6 7 8 9 10 11 12 13 14 15 16 17 5 
6 7 8 9 10 11 12 13 14 15 16 17 5 
6 7 8 9 10 11 12 13 14 15 16 17 18 
19 19 19 20 20 20 21 21 21 22 22 22 18 
23 23 23 24 24 24 25 25 25 26 26 26 18 
1 1 1 2 3 4 
5 6 7 2 3 4 
5 6 7 2 3 4 
5 6 7 8 9 10 
11 12 13 8 9 10 
11 12 13 8 9 10 
11 12 13 14 15 16 
17 18 19 14 15 16 
17 18 19 14 15 16 
17 18 19 20 21 22 
23 24 25 20 21 22 
23 24 25 20 21 22 
23 24 25 26 27 28 
29 30 31 26 27 28 
29 30 31 26 27 28 
29 30 31 32 33 34 
35 35 35 32 33 34 
36 36 36 32 33 34 
1 1 1 2 2 2 3 3 3 4 4 4 5 5 5 6 
7 8 9 10 11 12 13 14 15 16 17 18 19 20 21 6 
7 8 9 10 11 12 13 14 15 16 17 18 19 20 21 6 
7 8 9 10 11 12 13 14 15 16 17 18 19 20 21 22 
23 24 25 26 27 28 29 30 31 32 33 34 35 36 37 22 
23 24 25 26 27 28 29 30 31 32 33 34 35 36 37 22 
23 24 25 26 27 28 29 30 31 32 33 34 35 36 37 0 
38 38 38 39 39 39 40 40 40 41 41 41 42 42 42 0 
1 1 1 2 3 
4 5 6 2 3 
4 5 6 2 3 
4 5 6 7 8 
9 10 11 7 8 
9 10 11 7 8 
9 10 11 12 13 
14 15 16 12 13 
14 15 16 12 13 
14 15 16 17 18 
19 20 21 17 18 
19 20 21 17 18 
19 20 21 22 23 
24 25 26 22 23 
24 25 26 22 23 
24 25 26 0 0 
1 1 1 2 2 2 3 3 3 4 4 4 5 5 5 6 7 
8 9 10 11 12 13 14 15 16 17 18 19 20 21 22 6 7 
8 9 10 11 12 13 14 15 16 17 18 19 20 21 22 6 7 
8 9 10 11 12 13 14 15 16 17 18 19 20 21 22 23 24 
25 26 27 28 29 30 31 32 33 34 35 36 37 38 39 23 24 
25 26 27 28 29 30 31 32 33 34 35 36 37 38 39 23 24 
25 26 27 28 29 30 31 32 33 34 35 36 37 38 39 40 41 
42 43 44 45 46 47 48 49 50 51 52 53 54 55 56 40 41 
42 43 44 45 46 47 48 49 50 51 52 53 54 55 56 40 41 
42 43 44 45 46 47 48 49 50 51 52 53 54 55 56 57 58 
59 60 61 62 63 64 65 66 67 68 69 70 71 72 73 57 58 
59 60 61 62 63 64 65 66 67 68 69 70 71 72 73 57 58 
59 60 61 62 63 64 65 66 67 68 69 70 71 72 73 74 75 
76 76 76 77 77 77 78 78 78 79 79 79 80 80 80 74 75 
81 81 81 82 82 82 83 83 83 84 84 84 85 85 85 74 75 
1 1 1 2 2 2 3 3 3 4 5 
6 7 8 9 10 11 12 13 14 4 5 
6 7 8 9 10 11 12 13 14 4 5 
6 7 8 9 10 11 12 13 14 15 16 
17 18 19 20 21 22 23 24 25 15 16 
17 18 19 20 21 22 23 24 25 15 16 
17 18 19 20 21 22 23 24 25 26 27 
28 29 30 31 32 33 34 35 36 26 27 
28 29 30 31 32 33 34 35 36 26 27 
28 29 30 31 32 33 34 35 36 37 38 
39 40 41 42 43 44 45 46 47 37 38 
39 40 41 42 43 44 45 46 47 37 38 
39 40 41 42 43 44 45 46 47 48 49 
50 51 52 53 54 55 56 57 58 48 49 
50 51 52 53 54 55 56 57 58 48 49 
50 51 52 53 54 55 56 57 58 0 0 
1 1 1 2 
3 4 5 2 
3 4 5 2 
3 4 5 6 
7 8 9 6 
7 8 9 6 
7 8 9 10 
11 12 13 10 
11 12 13 10 
11 12 13 14 
15 16 17 14 
15 16 17 14 
15 16 17 0 
18 18 18 0 
1 1 1 2 2 2 3 3 3 4 4 4 5 5 5 6 7 
8 9 10 11 12 13 14 15 16 17 18 19 20 21 22 6 7 
8 9 10 11 12 13 14 15 16 17 18 19 20 21 22 6 7 
8 9 10 11 12 13 14 15 16 17 18 19 20 21 22 23 24 
25 26 27 28 29 30 31 32 33 34 35 36 37 38 39 23 24 
25 26 27 28 29 30 31 32 33 34 35 36 37 38 39 23 24 
25 26 27 28 29 30 31 32 33 34 35 36 37 38 39 40 41 
42 43 44 45 46 47 48 49 50 51 52 53 54 55 56 40 41 
42 43 44 45 46 47 48 49 50 51 52 53 54 55 56 40 41 
42 43 44 45 46 47 48 49 50 51 52 53 54 55 56 57 58 
59 60 61 62 63 64 65 66 67 68 69 70 71 72 73 57 58 
59 60 61 62 63 64 65 66 67 68 69 70 71 72 73 57 58 
59 60 61 62 63 64 65 66 67 68 69 70 71 72 73 74 75 
76 77 78 79 80 81 82 83 84 85 86 87 88 89 90 74 75 
76 77 78 79 80 81 82 83 84 85 86 87 88 89 90 74 75 
76 77 78 79 80 81 82 83 84 85 86 87 88 89 90 91 92 
93 93 93 94 94 94 95 95 95 96 96 96 97 97 97 91 92 
98 98 98 99 99 99 100 100 100 101 101 101 102 102 102 91 92 
