1 1 1 2 2 2 3 
4 5 6 7 8 9 3 
4 5 6 7 8 9 3 
4 5 6 7 8 9 0 
10 10 10 11 11 11 0 
1 1 1 2 2 2 3 4 5 
6 7 8 9 10 11 3 4 5 
6 7 8 9 10 11 3 4 5 
6 7 8 9 10 11 12 13 14 
15 16 17 18 19 20 12 13 14 
15 16 17 18 19 20 12 13 14 
15 16 17 18 19 20 21 21 21 
1 1 1 2 3 4 
5 6 7 2 3 4 
5 6 7 2 3 4 
5 6 7 8 9 10 
11 12 13 8 9 10 
11 12 13 8 9 10 
11 12 13 14 14 14 
15 15 15 16 16 16 
